vimd=VimD
vimdWins=VimWin
vimdModes=VimMode
objWin=objWins
arrMode=arrModes
arrHotIfWin=arrWinTitles
arrHistory=arrCmdHistory
lastAction=lastCmd
currentMode=activeMode
currentHotIfWin=curWinTitle
objHotIfWin_SingleKey=objRegHotkeys
count=repeatCount
isBreak=skipRepeat
isRepeat=isRepeating
funTipsCoordinate=tipPosFunc
keySuperVim=superKey
keyToMode0=normalModeKey
keyToMode1=vimModeKey
typeSuperVim=superModeType
objKeySuperVim=objSuperHotkeys
initWin=RegisterWin
errorDo=HandleError
key_hot2map=KeyHot2Map
key_map2send=KeyMap2Send
setBreak=SetSkipRepeat
GetCount=GetRepeatCount
changeMode=SwitchMode
keyIn=ProcessKey
_keyIn=_HandleKey
update=UpdateState
dealCount=HandleCount
setArrKeymapPressed=UpdateKeySeq
mapDefault=MapDefaults
mapCount=MapNumKeys
setGroup=DefineGroup
mapkey=MapKey
mapDynamic=MapDynamicKey
mapGroup=MapKeyGroup
_map=_CreateMap
key_Map2Action=KeyMap2Action
beforeKey=ShouldIntercept
callFunc=ExecAction
addTipsDynamic=AddDynamicTip
_show=_DisplayTooltip
objTips=objTooltips
objFunDynamic=objDynamicHandlers
objKeysmap=objKeyMaps
objFKey=objFirstKeyMap
arrKeymapPressed=arrKeySeq
sKeymapPressed=keySeqStr
arrDynamicTips=arrDynTooltips
